CASSQDYQGVDNEQFF	CASSEAGGQDYGNEQFF	local
CASSVFGIGVGGTYEQYF	CAWSEGGIGQPQHF	local
CASSVFGIGVGGTYEQYF	CSARDGTGIGDTQYF	local
CASSVFGIGVGGTYEQYF	CSVDGALAGGTYEQYF	local
CAWSEGGIGQPQHF	CSARDGTGIGDTQYF	local
CASSLASMGVGELFF	CASSSASGGVGELFF	local
CASSSPGVGANVLTF	CASSVDMVGANVLTF	local
CASSPRGGAYEQYF	CASTSGGAYEQYF	local
CASITSGGATGELFF	CASTSGGAYEQYF	local
CASITSGGATGELFF	CAWRSGGASPLHF	local
CASSATLGSLHYGYTF	CSAATLDGSNQPQHF	local
CASSNPYRGWGQNQPQHF	CASSEWGQGGAEQYF	local
CATSREWGEAYEQYF	CASSEWGQGGAEQYF	local
CASSFSPGLETQYF	CASSSGTGGLETQYF	local
CASNTLGAGGREQYF	CAWEKAGAGGTQYF	local
CASNTLGAGGREQYF	CASSQDGAGGREQFF	local
CASNTLGAGGREQYF	CASSQDGAGGREQFF	local
CASTSGGAYEQYF	CAWRSGGASPLHF	local
CSALLPTGGGEQYF	CASSPTGGTTYNSPLHF	local
CASSLEGQGNGYTF	CASSSGQGNQPQHF	local
CAWEKAGAGGTQYF	CASSQDGAGGREQFF	local
CASSFSTSGNTGELFF	CASSFSTSGNTGELFF	singleton
CASSLEGSGGTEAFF	CASSLEGSGGTEAFF	singleton
CASSLAPLQGTFRADTQYF	CASSLAPLQGTFRADTQYF	singleton
CASSLGGGSYNEQFF	CASSLGGGSYNEQFF	singleton
CASRTERESINEQFF	CASRTERESINEQFF	singleton
CASSATGLAGGGETQYF	CASSATGLAGGGETQYF	singleton
CAISAVGDRGTGELFF	CAISAVGDRGTGELFF	singleton
CASSEVWGSTHNEQFF	CASSEVWGSTHNEQFF	singleton
CATSLMGQPQHF	CATSLMGQPQHF	singleton
CASSQESRGGPVSYEQYF	CASSQESRGGPVSYEQYF	singleton
CASRPGQYSYEQYF	CASRPGQYSYEQYF	singleton
CAWSVLRGQYF	CAWSVLRGQYF	singleton
CASSIGRTYEQYF	CASSIGRTYEQYF	singleton
CASSLEATSRTQPQHF	CASSLEATSRTQPQHF	singleton
CASRPGTVNTGELFF	CASRPGTVNTGELFF	singleton
CASSLGGTPEPQHF	CASSLGGTPEPQHF	singleton
CASPGGWTGGGNEQFF	CASPGGWTGGGNEQFF	singleton
CASRENSGANVLTF	CASRENSGANVLTF	singleton
CASSLNAPGLGSTGELFF	CASSLNAPGLGSTGELFF	singleton
CASNLGTADSNQPQHF	CASNLGTADSNQPQHF	singleton
CSASGRAGESNEQFF	CSASGRAGESNEQFF	singleton
CASAREGPDTQYF	CASAREGPDTQYF	singleton
CAWSDGVVGEKLFF	CAWSDGVVGEKLFF	singleton
CASSLRRDYGYTF	CASSLRRDYGYTF	singleton
CSAAIVGQPQHF	CSAAIVGQPQHF	singleton
CASSPSGREDGYTF	CASSPSGREDGYTF	singleton
CASSWIAGVAGGAVADTQYF	CASSWIAGVAGGAVADTQYF	singleton
CSARDRDRYYEQYF	CSARDRDRYYEQYF	singleton
CSARAGGGDGELFF	CSARAGGGDGELFF	singleton
CASSFDEGTQHF	CASSFDEGTQHF	singleton
CASSLTGADSPLHF	CASSLTGADSPLHF	singleton
CASSQDEVGGRRAFF	CASSQDEVGGRRAFF	singleton
CASSPPTSEDAYNEQFF	CASSPPTSEDAYNEQFF	singleton
CSAGTYRTDTQYF	CSAGTYRTDTQYF	singleton
CSVGVMTYNEQFF	CSVGVMTYNEQFF	singleton
CASSPTIRDSGYTF	CASSPTIRDSGYTF	singleton
CASSQGLAAPYEQYF	CASSQGLAAPYEQYF	singleton
CASSLAAGPYGYTF	CASSLAAGPYGYTF	singleton
CAWSPGGETQYF	CAWSPGGETQYF	singleton
CATSRDLVGGNEQFF	CATSRDLVGGNEQFF	singleton
CASSEPGEQFF	CASSEPGEQFF	singleton
CASSLSGEKLFF	CASSLSGEKLFF	singleton
CASSLVSSPLHF	CASSLVSSPLHF	singleton
CASSFRGDDKNIQYF	CASSFRGDDKNIQYF	singleton
